................................................
....#######................###################..
####.....#####@##....#########################..
..............#####.............................
...................####....####.................
...........#####................................
..................####..........................
................................................
##############################..................
############################################....
................................................
...........................##########...........
................................................